Sistemas de Bancos de Dados (SGBDs)
construção do SGBDs -> inserção de ddos ​​-> SSD
Manipulação do BDs -> recuperação e relatórios -> QUERY
Compartilhamento -> acesso e simultaneidade -> GERENCIAMENTO

Usuário-> Aplicativo para fazer programas/Consultas-> Software para processar Consultas-> Software para acessar Dados Armazenados.

Metadados = Fornecem uma descrição concisa dos dados contidos no Banco de Dados.
SGBDs consultam os metadados após compilar as Queries

Por padrão o BD realiza o bloqueio e a liberação das tabelas.

##Modelos de Dados
Modelo de rede -> Links: Ponteiro entre nós - Relacionamento N:M/ cliente e conta
Modelo Hierárquico -> Registros:Links e Dados, árvore TAD - Raiz/ BDDBase COBOL Fox Pro
Modelo relacional -> Base de Álgebra Relacional - IBM SQL/DS - 1970
8 MB <_____________________________________________> TeraBytes
                        1980

LDD = Linguagem de Definição de Dados
Tradução -> Mecanismo de execução -> Gerenciador

LMD = Linguagem de Definição de Dados
alterar e extrai informações -> para executar

Starage & Buffer
Gerenciador de armazernamento = Trazer as informações do HD para a memória RAM ao contrário do Buffer.

Paraleismo = Múltiplos negócios operando;
Big Data = Processamento paralelo de dados;
Cloud = Nuvem - disponibilidade sob demanda de recursos.

##HPC = Computação de alto desempenho
1. Nós de processamento;
2. Sistemas de arquivos paralelos sem persistência;
3. Modelos: MPI, OpenMP, OpenCL;
4.Acesso: HFF5 e NetCDF.

##BIG DATA
1. Processo e Armazenamento: nós de processamento;
2. Sistema de arquivos paralelos persistentes;
3. Modelos: MapReduce, Spark< SGBDs paralelos.